####################..##################
#................ .....................#
#......................................#
##############.........................#
#......................................#
#......................................#
#......................................#
#...............C...................####
#......................................#
#..................................#####
#......................................#
#......................................#
#..................................#####
#......................................#
#............#############.............#
#............#           #..............
#............#            ..............
#............#            .............#
#............#           #.............#
#............#############.............#
#......................................#
#......................................#
#......................................#
#..................C...................#
#......................................#
#......................................#
#......................................#
#......................................#
#......................................#
#............................C.........#
#......................................#
#                   ...........        #
#       .......................        #
#       .............        ..........#
#     .................................#
#              ...............         #
#......................................#
#...................@..................#
##.....................................#
##################..####################