####################xx##################
#................ .....................#
#......................................#
##############..............@..........#
#......................................#
#......................................#
#......................................#
#...............C...................####
#......................................#
#..................................#####
#......................................#
#......................................#
#..................................#####
#......................................#
.............#############......########
.............#           #......#       
#............#            ......#       
#............#            ......#       
#............#           #......########
#............#############.............#
#......................................#
#......................................#
#......................................#
#..................C...................#
#......................................#
#......................................#
#......................................#
#......................................#
#......................................#
#............................C.........#
#......................................#
#                   ...........        #
#       .......................        #
#       ............#.#................#
#     .................................#
#              .....#.#.......         #
#......................................#
#......................................#
##.....................................#